# Glossary in tab-separated format -*- coding: utf-8 -*-
deck	deque
Cross-platform	Multiplataforma
IF	SE
IFERROR	SEERRO
IFNA	SE.É.NÃO.DISP
CHOOSE	ESCOLHER
AND	E
OR	OU
XOR	XOU
NOT	NÃO
NEG	NEG
PI	PI
RAND	ALEATÓRIO
TRUE	VERDADEIRO
FALSE	FALSO
TODAY	HOJE
NOW	AGORA
NA	NÃO.DISP
CURRENT	ATUAL
DEGREES	GRAUS
RADIANS	RADIANOS
SIN	SEN
COS	COS
TAN	TAN
COT	COT
ASIN	ASEN
ACOS	ACOS
ATAN	ATAN
ACOT	ACOT
SINH	SENH
COSH	COSH
TANH	TANH
COTH	COTH
ASINH	ASENH
ACOSH	ACOSH
ATANH	ATANH
ACOTH	ACOTH
CSC	COSEC
SEC	SEC
CSCH	COSECH
SECH	SECH
EXP	EXP
LN	LN
SQRT	RAIZ
FACT	FATORIAL
YEAR	ANO
MONTH	MÊS
DAY	DIA
HOUR	HORA
MINUTE	MINUTO
SECOND	SEGUNDO
SIGN	SINAL
ABS	ABS
INT	INT
PHI	FI
GAUSS	GAUSS
ISBLANK	ÉCÉL.VAZIA
ISTEXT	ÉTEXTO
ISNONTEXT	É.NÃO.TEXTO
ISLOGICAL	ÉLÓGICO
TYPE	TIPO
CELL	CÉL
ISREF	ÉREF
ISNUMBER	ÉNUM
ISFORMULA	ÉFÓRMULA
ISNA	É.NÃO.DISP
ISERR	ÉERRO
ISERROR	ÉERROS
ISEVEN	ÉPAR
ISODD	ÉÍMPAR
N	N
DATEVALUE	DATA.VALOR
TIMEVALUE	VALOR.TEMPO
CODE	CÓDIGO
TRIM	ARRUMAR
UPPER	MAIÚSCULA
PROPER	PRI.MAIÚSCULA
LOWER	MINÚSCULA
LEN	NÚM.CARACT
T	T
VALUE	VALOR
CLEAN	TIRAR
CHAR	CARACT
JIS	JIS
ASC	ASC
UNICODE	UNICODE
UNICHAR	CARACT.UNICODE
LOG10	LOG10
EVEN	PAR
ODD	ÍMPAR
NORMSDIST	DIST.NORMP
NORM.S.DIST	DIST.NORMP.N
FISHER	FISHER
FISHERINV	FISHERINV
NORMSINV	INV.NORMP
NORM.S.INV	INV.NORMP.N
GAMMALN	LNGAMA
GAMMALN.PRECISE	LNGAMA.PRECISO
ERRORTYPE	TIPODEERRO
ERROR.TYPE	TIPO.ERRO
FORMULA	FÓRMULA
ARABIC	ÁRABE
ATAN2	ATAN2
CEILING.MATH	TETO.MAT
CEILING	TETO
CEILING.XCL	TETO.XCL
CEILING.PRECISE	TETO.PRECISO
ISO.CEILING	ISO.TETO
FLOOR	ARREDMULTB
FLOOR.XCL	ARREDMULTB.XCL
FLOOR.MATH	ARREDMULTB.MAT
FLOOR.PRECISE	ARREDMULTB.PRECISO
ROUND	ARRED
ROUNDUP	ARREDONDAR.PARA.CIMA
ROUNDDOWN	ARREDONDAR.PARA.BAIXO
TRUNC	TRUNCAR
LOG	LOG
POWER	POTÊNCIA
GCD	MDC
LCM	MMC
MOD	MOD
SUMPRODUCT	SOMARPRODUTO
SUMSQ	SOMAQUAD
SUMX2MY2	SOMAX2DY2
SUMX2PY2	SOMAX2SY2
SUMXMY2	SOMAXMY2
DATE	DATA
TIME	TEMPO
DAYS	DIAS
DAYS360	DIAS360
DATEDIF	DATADIF
MIN	MÍNIMO
MINA	MÍNIMOA
MAX	MÁXIMO
MAXA	MÁXIMOA
SUM	SOMA
PRODUCT	MULT
AVERAGE	MÉDIA
AVERAGEA	MÉDIAA
COUNT	CONT.NÚM
COUNTA	CONT.VALORES
NPV	VPL
IRR	TIR
MIRR	MTIR
ISPMT	ÉPGTO
VAR	VAR
VARA	VARA
VARP	VARP
VARPA	VARPA
VAR.P	VAR.P
VAR.S	VAR.S
STDEV	DESVPAD
STDEVA	DESVPADA
STDEVP	DESVPADP
STDEVPA	DESVPADPA
STDEV.P	DESVPAD.P
STDEV.S	DESVPAD.A
B	B
NORMDIST	DIST.NORM
NORM.DIST	DIST.NORM.N
EXPONDIST	DISTEXPON
EXPON.DIST	DISTR.EXPON
BINOMDIST	DISTRBINOM
BINOM.DIST	DISTR.BINOM
POISSON	POISSON
POISSON.DIST	DIST.POISSON
COMBIN	COMBIN
COMBINA	COMBINA
PERMUT	PERMUTAR
PERMUTATIONA	PERMUTAÇÃOA
PV	VP
SYD	SDA
DDB	BDD
DB	BD
VDB	BDV
PDURATION	DURACAOP
SLN	DPD
PMT	PGTO
COLUMNS	COLUNAS
ROWS	LINHAS
SHEETS	PLANILHAS
COLUMN	COLUNA
ROW	LINHA
SHEET	PLANILHA
RRI	RINV
FV	VF
NPER	NPER
RATE	TAXA
IPMT	IPGTO
PPMT	PPGTO
CUMIPMT	IPGTO.CUM
CUMPRINC	PGTOPRINC
EFFECT	EFETIVA
NOMINAL	NOMINAL
SUBTOTAL	SUBTOTAL
DSUM	BDSOMA
DCOUNT	BDCONTAR
DCOUNTA	BDCONTARA
DAVERAGE	BDMÉDIA
DGET	BDEXTRAIR
DMAX	BDMÁX
DMIN	BDMÍN
DPRODUCT	BDMULTIPL
DSTDEV	BDEST
DSTDEVP	BDDESVPA
DVAR	BDVAREST
DVARP	BDVARP
INDIRECT	INDIRETO
ADDRESS	ENDEREÇO
MATCH	CORRESP
XMATCH	CORRESPX
COUNTBLANK	CONTAR.VAZIO
COUNTIF	CONT.SE
SUMIF	SOMASE
AVERAGEIF	MÉDIASE
SUMIFS	SOMASES
AVERAGEIFS	MÉDIASES
COUNTIFS	CONT.SES
LOOKUP	PROC
VLOOKUP	PROCV
XLOOKUP	PROCX
HLOOKUP	PROCH
FILTER	FILTRO
SORT	ORDENAR
SORTBY	ORDENAR.POR
UNIQUE	ÚNICO
LET	LET
MULTIRANGE	INTERVALOMULT
OFFSET	DESLOC
INDEX	ÍNDICE
AREAS	ÁREAS
DOLLAR	MOEDA
REPLACE	MUDAR
FIXED	DEF.NÚM.DEC
FIND	PROCURAR
EXACT	EXATO
LEFT	ESQUERDA
RIGHT	DIREITA
SEARCH	LOCALIZAR
MID	EXT.TEXTO
LENB	NÚM.CARACTB
RIGHTB	DIREITAB
LEFTB	ESQUERDAB
REPLACEB	SUBSTITUIRB
MIDB	EXT.TEXTOB
TEXT	TEXTO
SUBSTITUTE	SUBSTITUIR
REPT	REPT
CONCATENATE	CONCATENAR
CONCAT	CONCAT
TEXTJOIN	UNIRTEXTO
IFS	SES
SWITCH	PARÂMETRO
MINIFS	MÍNIMOSES
MAXIFS	MÁXIMOSES
MVALUE	MATRIZ.VALOR
MDETERM	MATRIZ.DETERM
MINVERSE	MATRIZ.INVERSO
MMULT	MATRIZ.MULT
SEQUENCE	SEQUÊNCIA
TRANSPOSE	TRANSPOR
MUNIT	MATRIZ.UNIDADE
GOALSEEK	ATINGIR.META
HYPGEOMDIST	DIST.HIPERGEOM
HYPGEOM.DIST	DIST.HIPERGEOM.N
LOGNORMDIST	DIST.LOGNORMAL
LOGNORM.DIST	DIST.LOGNORMAL.N
TDIST	DISTT
T.DIST.2T	DIST.T.BC
T.DIST	DIST.T
T.DIST.RT	DIST.T.CD
FDIST	DISTF
F.DIST	DIST.F
F.DIST.RT	DIST.F.CD
CHIDIST	DIST.QUI
CHISQ.DIST.RT	DIST.QUIQUA.CD
WEIBULL	WEIBULL
WEIBULL.DIST	DIST.WEIBULL
NEGBINOMDIST	DIST.BIN.NEG
NEGBINOM.DIST	DIST.BIN.NEG.N
CRITBINOM	CRIT.BINOM
BINOM.INV	INV.BINOM
KURT	CURT
HARMEAN	MÉDIA.HARMÔNICA
GEOMEAN	MÉDIA.GEOMÉTRICA
STANDARDIZE	PADRONIZAR
AVEDEV	DESV.MÉDIO
SKEW	DISTORÇÃO
SKEWP	DISTORÇÃOP
DEVSQ	DESVQ
MEDIAN	MED
MODE	MODO
MODE.SNGL	MODO.ÚNICO
MODE.MULT	MODO.MULT
ZTEST	TESTEZ
Z.TEST	TESTE.Z
AGGREGATE	AGREGAR
TTEST	TESTET
T.TEST	TESTE.T
RANK	ORDEM
PERCENTILE	PERCENTIL
PERCENTRANK	ORDEM.PORCENTUAL
PERCENTILE.INC	PERCENTIL.INC
PERCENTRANK.INC	ORDEM.PORCENTUAL.INC
QUARTILE.INC	QUARTIL.INC
RANK.EQ	ORDEM.EQ
PERCENTILE.EXC	PERCENTIL.EXC
PERCENTRANK.EXC	ORDEM.PORCENTUAL.EXC
QUARTILE.EXC	QUARTIL.EXC
RANK.AVG	ORDEM.MÉD
LARGE	MAIOR
SMALL	MENOR
FREQUENCY	FREQUÊNCIA
QUARTILE	QUARTIL
NORMINV	INV.NORM
NORM.INV	INV.NORM.N
CONFIDENCE	INT.CONFIANÇA
CONFIDENCE.NORM	INT.CONFIANÇA.NORM
CONFIDENCE.T	INT.CONFIANÇA.T
FTEST	TESTEF
F.TEST	TESTE.F
TRIMMEAN	MÉDIA.INTERNA
PROB	PROB
CORREL	CORREL
COVAR	COVAR
COVARIANCE.P	COVARIÂNCIA.P
COVARIANCE.S	COVARIÂNCIA.S
PEARSON	PEARSON
RSQ	RQUAD
STEYX	EPADYX
SLOPE	INCLINAÇÃO
INTERCEPT	INTERCEPÇÃO
TREND	TENDÊNCIA
GROWTH	CRESCIMENTO
LINEST	PROJ.LIN
LOGEST	PROJ.LOG
FORECAST	PREVISAO
FORECAST.ETS.ADD	PREVISAO.ETS.ADIC
FORECAST.ETS.SEASONALITY	PREVISAO.ETS.SAZONALIDADE
FORECAST.ETS.MULT	PREVISAO.ETS.MULT
FORECAST.ETS.PI.ADD	PREVISAO.ETS.INTCONF.ADIC
FORECAST.ETS.PI.MULT	PREVISAO.ETS.INTCONF.MULT
FORECAST.ETS.STAT.ADD	PREVISAO.ETS.ESTAT.ADIC
FORECAST.ETS.STAT.MULT	PREVISAO.ETS.ESTAT.MULT
FORECAST.LINEAR	PREVISAO.LINEAR
CHIINV	INV.QUI
CHISQ.INV.RT	INV.QUIQUA.CD
GAMMADIST	DISTGAMA
GAMMA.DIST	DIST.GAMA
GAMMAINV	INVGAMA
GAMMA.INV	INV.GAMA
TINV	INVT
T.INV.2T	INV.T.BC
T.INV	INV.T
FINV	INVF
F.INV	INV.F
F.INV.RT	F.INV.CD
CHITEST	TESTE.QUI
CHISQ.TEST	TESTE.QUIQUA
LOGINV	INVLOG
LOGNORM.INV	INV.LOGNORMAL
MULTIPLE.OPERATIONS	OPERAÇÕES.MÚLTIPLAS
BETADIST	DISTBETA
BETAINV	BETA.ACUM.INV
BETA.DIST	DIST.BETA
BETA.INV	INV.BETA
WEEKNUM	NÚM.SEMANA
ISOWEEKNUM	NUMSEMANAISO
WEEKNUMOOO	NÚM.SEMANAOOO
EASTERSUNDAY	DOMINGODEPÁSCOA
WEEKDAY	DIA.DA.SEMANA
NETWORKDAYS	DIATRABALHOTOTAL
NETWORKDAYS.INTL	DIATRABALHOTOTAL.INTL
WORKDAY.INTL	DIATRABALHO.INTL
STYLE	ESTILO
DDE	DDE
BASE	BASE
DECIMAL	DECIMAL
CONVERTOOO	CONVERTEROOO
ROMAN	ROMANO
HYPERLINK	HIPERLINK
INFO	INFO
BAHTTEXT	BAHTTEXT
GETPIVOTDATA	INFODADOSTABELADINÂMICA
EUROCONVERT	CONVERTEREURO
NUMBERVALUE	VALORNUMERICO
GAMMA	GAMA
CHISQDIST	DIST.QUI.QUAD
CHISQ.DIST	DIST.QUIQUA
CHISQINV	INV.QUI.QUAD
CHISQ.INV	INV.QUIQUA
BITAND	BIT.E
BITOR	BIT.OU
BITXOR	BIT.XOU
BITRSHIFT	BIT.DESLOC.DIR
BITLSHIFT	BIT.DESLOC.ESQ
FILTERXML	FILTROXML
COLOR	COR
WEBSERVICE	SERVIÇOWEB
ERF.PRECISE	FUNERRO.PRECISO
ERFC.PRECISE	FUNERROCOMPL.PRECISO
ENCODEURL	CODIFURL
RAWSUBTRACT	SUBTRAC.NATURAL
ROUNDSIG	ARRED.SIGNIF
FINDB	PROCURARB
SEARCHB	LOCALIZARB
REGEX	EXPREG
FOURIER	FOURIER
RAND.NV	ALEATORIO.NV
RANDBETWEEN.NV	ALEATORIOENTRE.NV
RANDARRAY	MATRIZALEATÓRIA
Add	Adicionar
Apply	Aplicar
Cancel	Cancelar
Close	Fechar
Delete	Excluir
Edit	Editar
Help	Ajuda
New	Novo
No	Não
OK	OK
Remove	Remover
Reset	Redefinir
Yes	Sim
(optional)	(opcional)
(required)	(necessário)
End	Finalizar
Shrink	Encolher
Expand	Expandir
Array	Matricial
Back	Voltar
Next	Próximo
Functions	Funções
Structure	Estrutura
Formula:	Fórmula:
Result:	Resultado:
Formula	Fórmula
Maximize	Maximizar
Search:	Pesquisar:
Similar	Similar
Category:	Categoria:
All	Todas
Start Center	Centro de partida
drop-down list	lista suspensa
Keyboard shortcut	Atalho de teclado
layout	leiaute	Seguindo a norma culta.
table of contents	sumário
tables of contents	sumários
Customizing	Personalizar
escritor	Writer
